############################
#............##............#
#.####.#####.##.#####.####.#
#@####.#####.##.#####.####@#
#.####.#####.##.#####.####.#
#..........................#
#.####.##.########.##.####.#
#.####.##.########.##.####.#
#......##....##....##......#
######.##### ## #####.######
     #.##### ## #####.#     
     #.##          ##.#     
     #.## ???--??? ##.#     
######.## ???????? ##.######
~     .   ?<><><>?   .     ~
######.## ???????? ##.######
     #.## ???????? ##.#     
     #.##          ##.#     
     #.## ######## ##.#     
######.## ######## ##.######
#............##............#
#.####.#####.##.#####.####.#
#@####.#####.##.#####.####@#
#...##.......<>.......##...#
###.##.##.########.##.##.###
###.##.##.########.##.##.###
#......##....##....##......#
#.##########.##.##########.#
#.##########.##.##########.#
#..........................#
############################