############################
#............##............#
#.####.#####.##.#####.####.#
#@####.#####.##.#####.####@#
#.####.#####.##.#####.####.#
#..........................#
#.####.##.########.##.####.#
#.####.##.########.##.####.#
#......##....##....##......#
######.#####_##_#####.######
######.#####_##_#####.######
######.##__________##.######
######.##_???--???_##.######
######.##_????????_##.######
~_____.___?<><><>?___._____~
######.##_????????_##.######
######.##_????????_##.######
######.##__________##.######
######.##_########_##.######
######.##_########_##.######
#............##............#
#.####.#####.##.#####.####.#
#.####.#####.##.#####.####.#
#@..##.......<>.......##..@#
###.##.##.########.##.##.###
###.##.##.########.##.##.###
#......##....##....##......#
#.##########.##.##########.#
#.##########.##.##########.#
#..........................#
############################
